WWWWWWWWWWWWWWW
WP    BBB BBBBW
W W W W W W W W
W         Y B W
WBW R W W WBW W
W       R  B  W
W W W W Y W W W
WB   B   B    W
WBW R W WBW W W
W    YBB   B BW
W WBW W W R W W
W        B   GW
WWWWWWWWWWWWWWW